ศรีญาดา	NN	B_PER	B_CLS
ห่วง	VV	O	I_CLS
ม็อบ	NN	O	I_CLS
คณะ	NN	B_ORG	I_CLS
พนักงาน	NN	I_ORG	I_CLS
สอบสวน	NN	I_ORG	I_CLS
คดี	NN	I_ORG	I_CLS
หมิ่น	NN	I_ORG	I_CLS
เบื้อง	NN	I_ORG	I_CLS
สูง	NN	E_ORG	I_CLS
เตรียม	VV	O	I_CLS
ใช้	VV	O	I_CLS
แผน	NN	O	I_CLS
ตากสิน	NN	O	I_CLS
_	PU	O	I_CLS
2	NU	B_NUM	I_CLS
_	PU	O	I_CLS
ฮือ	NN	O	I_CLS
_	PU	O	I_CLS
27	NU	B_DTM	I_CLS
_	PU	I_DTM	I_CLS
มิ.ย.	NN	E_DTM	E_CLS

วัน	NN	B_DTM	B_CLS
นี้	AJ	E_DTM	I_CLS
(	PU	O	I_CLS
25	NU	B_DTM	I_CLS
_	PU	I_DTM	I_CLS
มิ.ย.	NN	I_DTM	I_CLS
52	NU	E_DTM	I_CLS
)	PU	O	I_CLS
_	PU	O	I_CLS
กัปตัน	NN	B_DES	I_CLS
สรวีย์	NN	B_PER	I_CLS
_	PU	I_PER	I_CLS
คลังแสง	NN	E_PER	I_CLS
_	PU	O	I_CLS
ประธาน	NN	O	I_CLS
องคมนตรี	NN	O	I_CLS
และ	CC	O	I_CLS
รัฐบุรุษ	NN	O	I_CLS
_	PU	O	I_CLS
เป็น	VV	O	I_CLS
ประธาน	NN	O	I_CLS
เปิด	VV	O	I_CLS
งาน	NN	O	I_CLS
_	PU	O	I_CLS
"	PU	O	I_CLS
สหกรุ๊ป	NN	O	I_CLS
แฟร์	NN	O	I_CLS
_	PU	O	I_CLS
ครั้ง	CL	O	I_CLS
ที่	CC	O	E_CLS
_	PU	O	O
13"	NN	O	B_CLS
_	PU	O	I_CLS
ที่	PS	O	I_CLS
ศูนย์	NN	O	I_CLS
การ	FX	O	I_CLS
ประชุมแห่งชาติสิริกิติ์	VV	O	E_CLS
_	PU	O	O
และ	CC	O	B_CLS
ให้	AV	O	I_CLS
สัมภาษณ์	VV	O	I_CLS
ถึง	PS	O	E_CLS
กรณีที่	CC	O	B_CLS
มี	VV	O	I_CLS
รายงาน	VV	O	I_CLS
ข่าว	NN	O	I_CLS
จาก	PS	O	I_CLS
หน่วย	NN	O	I_CLS
ข่าว	NN	O	I_CLS
ด้าน	PS	O	I_CLS
ความ	FX	O	I_CLS
มั่นคง	VV	O	I_CLS
ระบุ	VV	O	I_CLS
กองทุน	NN	B_ORG	I_CLS
น้ำมัน	NN	I_ORG	I_CLS
เชื้อเพลิง	NN	E_ORG	I_CLS
เตรียม	VV	O	I_CLS
ใช้	VV	O	I_CLS
แผน	NN	O	I_CLS
ตากสิน	NN	O	I_CLS
_	PU	O	I_CLS
2	NU	B_NUM	E_CLS

ใน	PS	O	B_CLS
การ	FX	O	I_CLS
ชุมนุม	VV	O	I_CLS
ใหญ่	VV	O	I_CLS
ใน	PS	O	I_CLS
วันที่	NN	B_DTM	I_CLS
_	PU	I_DTM	I_CLS
27	NU	I_DTM	I_CLS
_	PU	I_DTM	I_CLS
มิถุนายน	NN	E_DTM	E_CLS
_	PU	O	O
ว่า	CC	O	B_CLS
_	PU	O	O
ทราบ	VV	O	B_CLS
เรื่อง	NN	O	I_CLS
นี้	AJ	O	I_CLS
จาก	PS	O	I_CLS
การ	FX	O	I_CLS
อ่าน	VV	O	I_CLS
หนังสือพิมพ์	NN	O	E_CLS

อย่างไรก็ตาม	CC	O	B_CLS
_	PU	O	I_CLS
ใน	PS	O	I_CLS
ฐานะ	NN	O	I_CLS
คน	NN	O	I_CLS
เขื่อน	NN	B_LOC	I_CLS
รัช	NN	I_LOC	I_CLS
ช	NN	I_LOC	I_CLS
ประภา	NN	E_LOC	I_CLS
รู้สึก	VV	O	I_CLS
ห่วง	VV	O	I_CLS
ประเทศชาติ	NN	O	I_CLS
เหมือนกัน	AV	O	E_CLS
_	PU	O	O
แต่	CC	O	B_CLS
การ	FX	O	I_CLS
ดูแล	VV	O	I_CLS
ทั้งหมด	PR	O	I_CLS
ถือ	VV	O	I_CLS
เป็น	VV	O	I_CLS
หน้าที่	NN	O	I_CLS
ของ	PS	O	I_CLS
รัฐบาล	NN	O	E_CLS



