สถานี	NN	B_ORG	B_CLS
ตำรวจนอตติงแฮมเชียร์	NN	E_ORG	I_CLS
เจ้าภาพ	NN	O	I_CLS
เตรียม	VV	O	I_CLS
จัด	VV	O	I_CLS
งาน	NN	O	I_CLS
วัน	NN	B_DTM	I_CLS
แม่	NN	E_DTM	E_CLS

นาย	NN	B_TTL	B_CLS
กรวีร์	NN	B_PER	I_CLS
_	PU	I_PER	I_CLS
ไชยสัจ	NN	E_PER	I_CLS
_	PU	O	I_CLS
รัฐมนตรี	NN	O	I_CLS
ว่าการ	VV	O	I_CLS
ปปส.	NN	B_ORG	I_CLS
_	PU	O	I_CLS
กล่าว	VV	O	I_CLS
ผ่าน	VV	O	I_CLS
ทาง	NN	O	I_CLS
วีดิทัศน์	NN	O	I_CLS
ทาง	NN	O	I_CLS
ไกล	VV	O	I_CLS
_	PU	O	I_CLS
(	PU	O	I_CLS
วิดีโอ	NN	O	I_CLS
คอนเฟอเรนซ์	NN	O	I_CLS
)	PU	O	I_CLS
_	PU	O	I_CLS
ไป	VV	O	I_CLS
ยัง	PS	O	I_CLS
ผู้	FX	O	I_CLS
ว่าราชการ	VV	O	I_CLS
จังหวัด	NN	O	I_CLS
ทั่ว	AJ	O	I_CLS
ประเทศ	NN	O	I_CLS
ว่า	CC	O	E_CLS
_	PU	O	O
สั่งการ	VV	O	E_CLS
ให้	CC	O	B_CLS
ผู้	FX	O	I_CLS
บริหาร	VV	O	I_CLS
กระทรวง	NN	O	I_CLS
เร่ง	VV	O	I_CLS
ดำเนินการ	VV	O	I_CLS
_	PU	O	I_CLS
เรื่อง	NN	O	I_CLS
งาน	NN	O	I_CLS
เฉลิม	VV	O	I_CLS
พระเกียรติ	NN	O	I_CLS
ศ.นพ.	NN	B_DES	I_CLS
_	PU	O	I_CLS
โปร	NN	B_DES	I_CLS
_	PU	O	I_CLS
เนื่อง	PS	O	I_CLS
ใน	PS	O	I_CLS
โอกาส	NN	O	I_CLS
มหามงคล	NN	O	I_CLS
เฉลิม	VV	O	I_CLS
พระชนมพรรษา	NN	O	I_CLS
_	PU	O	I_CLS
77	NU	B_MEA	I_CLS
_	PU	O	I_CLS
พรรษา	CL	B_MEA	I_CLS
_	PU	O	I_CLS
12	NU	B_DTM	I_CLS
_	PU	I_DTM	I_CLS
สิงหา	NN	E_DTM	E_CLS

โดย	CC	O	B_CLS
ใน	PS	O	I_CLS
ส่วน	NN	O	I_CLS
กลาง	NN	O	I_CLS
จะ	AX	O	I_CLS
มีการ	FX	O	I_CLS
จัด	VV	O	I_CLS
พิธี	NN	O	E_CLS
_	PU	O	O
และ	CC	O	B_CLS
แสดง	VV	O	I_CLS
มหรสพ	NN	O	I_CLS
_	PU	O	I_CLS
ตั้งแต่	PS	O	I_CLS
อำเภอ	NN	B_LOC	I_CLS
เมือง	NN	I_LOC	I_CLS
เลย	NN	E_LOC	I_CLS
_	PU	O	I_CLS
ตลอด	AJ	O	I_CLS
โรงเรียน	NN	B_LOC	I_CLS
กาสร	NN	I_LOC	I_CLS
กสิ	NN	I_LOC	I_CLS
วิทย์	NN	E_LOC	I_CLS
_	PU	O	I_CLS
จนถึง	PS	O	I_CLS
ลาน	NN	O	I_CLS
สมุทรปราการ	NN	B_LOC	E_CLS

โดย	CC	O	B_CLS
คณะ	NN	B_ORG	I_CLS
กรรมการ	NN	I_ORG	I_CLS
ควบคุม	NN	I_ORG	I_CLS
เครื่อง	NN	I_ORG	I_CLS
ดื่ม	NN	I_ORG	I_CLS
แอลกอฮอล์	NN	I_ORG	I_CLS
จังหวัด	NN	E_ORG	I_CLS
_	PU	O	I_CLS
ได้รับ	VV	O	I_CLS
มอบ	VV	O	E_CLS
ให้	CC	O	B_CLS
เป็น	VV	O	I_CLS
หน่วยงาน	NN	O	I_CLS
เจ้าภาพ	NN	O	E_CLS
_	PU	O	O
และ	CC	O	B_CLS
จะ	AX	O	I_CLS
เพิ่มเติม	VV	O	I_CLS
กิจกรรม	NN	O	E_CLS
โดย	CC	O	B_CLS
จัด	VV	O	I_CLS
กิจกรรม	NN	O	I_CLS
ปลูก	VV	O	I_CLS
ต้น	NN	O	I_CLS
ไม้	NN	O	I_CLS
_	PU	O	I_CLS
"	PU	O	I_CLS
แม่	NN	O	I_CLS
ทั้ง	AJ	O	I_CLS
ประเทศ	NN	O	I_CLS
_	PU	O	I_CLS
ปลูก	VV	O	I_CLS
ต้น	NN	O	I_CLS
ไม้	NN	O	I_CLS
ถวาย	VV	O	I_CLS
แม่	NN	O	I_CLS
ของ	PS	O	I_CLS
แผ่นดิน	NN	O	I_CLS
_	PU	O	I_CLS
จำนวน	NN	O	I_CLS
_	PU	O	I_CLS
77	NU	B_NUM	I_CLS
_	PU	I_NUM	I_CLS
ล้าน	NU	E_NUM	I_CLS
ต้น	CL	O	I_CLS
"	PU	O	E_CLS



