เรอัลมาดริด	NN	B_ORG	B_CLS
_	PU	O	I_CLS
ต้อง	AX	O	I_CLS
เจอ	VV	O	I_CLS
อุปสรรค	NN	O	I_CLS
ใน	PS	O	I_CLS
การ	FX	O	I_CLS
ไล่ล่า	VV	O	I_CLS
ตัว	NN	O	I_CLS
_	PU	O	I_CLS
จักพันธ์	NN	B_PER	I_CLS
_	PU	O	I_CLS
พาณุวัฒณ์	NN	B_PER	I_CLS
_	PU	O	I_CLS
ปีก	NN	O	I_CLS
จอม	NN	O	I_CLS
สับ	VV	O	I_CLS
ของ	PS	O	I_CLS
องค์การ	NN	B_ORG	I_CLS
บริหาร	NN	I_ORG	I_CLS
ส่วน	NN	I_ORG	I_CLS
ตำบล	NN	I_ORG	I_CLS
คลองสะแก	NN	E_ORG	I_CLS
_	PU	O	I_CLS
เสีย	VV	O	I_CLS
แล้ว	AX	O	E_CLS

หลัง	CC	O	B_CLS
คณะ	NN	B_ORG	I_CLS
ผู้	NN	I_ORG	I_CLS
บริหาร	NN	I_ORG	I_CLS
เกาะฮ่องกง	NN	E_ORG	I_CLS
_	PU	O	I_CLS
สื่อ	NN	O	I_CLS
ชื่อ	NN	O	I_CLS
ดัง	VV	O	I_CLS
แห่ง	PS	O	I_CLS
สหมงคลฟิล์ม	NN	B_ORG	I_CLS
_	PU	O	I_CLS
เปิดเผย	VV	O	I_CLS
ว่า	CC	O	E_CLS
_	PU	O	O
คำพอง	NN	B_PER	B_CLS
_	PU	I_PER	I_CLS
ช่างเหลา	NN	E_PER	I_CLS
_	PU	O	I_CLS
กรรมการ	NN	B_DES	I_CLS
ผู้	NN	I_DES	I_CLS
อำนวยการ	NN	I_DES	I_CLS
ใหญ่	NN	E_DES	I_CLS
บอร์ด	NN	I_DES	I_CLS
บริหาร	VV	E_DES	I_CLS
_	PU	O	I_CLS
"	PU	O	I_CLS
ธนาคาร	NN	B_ORG	I_CLS
กรุงเทพ	NN	I_ORG	I_CLS
_	NN	I_ORG	I_CLS
สาขา	NN	I_ORG	I_CLS
ตลิ่งชัน	NN	E_ORG	I_CLS
"	PU	O	I_CLS
_	PU	O	I_CLS
ประกาศ	VV	O	I_CLS
ขึ้น	AV	O	I_CLS
ป้าย	NN	O	I_CLS
ขาย	VV	O	I_CLS
ปีก	NN	O	I_CLS
วัย	NN	O	I_CLS
_	PU	O	I_CLS
24	NU	B_MEA	I_CLS
_	PU	O	I_CLS
ปี	CL	B_MEA	I_CLS
ราย	CL	O	I_CLS
นี้	AJ	O	I_CLS
เป็น	VV	O	I_CLS
จำนวน	NN	O	I_CLS
เงิน	NN	O	I_CLS
สูง	VV	O	I_CLS
ถึง	PS	O	I_CLS
_	PU	O	I_CLS
(	PU	O	I_CLS
ประมาณ	AJ	O	I_CLS
_	PU	O	I_CLS
4.8	NU	B_MEA	I_CLS
_	PU	I_MEA	I_CLS
พัน	NU	I_MEA	I_CLS
ล้าน	NU	I_MEA	I_CLS
บาท	CL	E_MEA	I_CLS
)	PU	O	I_CLS
_	PU	O	I_CLS
เลย	AV	O	I_CLS
ทีเดียว	AV	O	E_CLS

ส่ง	VV	O	B_CLS
ผล	NN	O	I_CLS
ให้	CC	O	E_CLS
_	PU	O	O
เทียบจุฑา	NN	B_PER	B_CLS
_	PU	I_PER	I_CLS
วิวรรธนดิฐกุล	NN	E_PER	I_CLS
_	PU	O	I_CLS
ส.ส.	NN	B_DES	I_CLS
สโมสร	NN	E_DES	I_CLS
_	PU	O	I_CLS
"	PU	O	I_CLS
สสจ.	NN	B_ORG	I_CLS
ชัยภูมิ	NN	E_ORG	I_CLS
"	PU	O	I_CLS
_	PU	O	I_CLS
อาจ	AX	O	I_CLS
ต้อง	AX	O	I_CLS
ทบทวน	VV	O	I_CLS
อย่าง	FX	O	I_CLS
หนัก	VV	O	I_CLS
อีก	AJ	O	I_CLS
ครั้ง	CL	O	I_CLS
หนึ่ง	NU	O	E_CLS
_	PU	O	O
เนื่องจาก	CC	O	B_CLS
_	PU	O	O
สน.	NN	B_ORG	B_CLS
วังทองหลาง	NN	E_ORG	I_CLS
_	PU	O	I_CLS
ต้อง	AX	O	I_CLS
ยอม	VV	O	I_CLS
ควัก	VV	O	I_CLS
กระเป๋า	NN	O	I_CLS
จ่าย	VV	O	I_CLS
เงิน	NN	O	I_CLS
ค่า	NN	O	I_CLS
หัว	NN	O	I_CLS
จำนวน	NN	O	I_CLS
ดังกล่าว	AJ	O	E_CLS
เพื่อ	CC	O	B_CLS
เป็น	VV	O	I_CLS
การ	FX	O	I_CLS
พัง	VV	O	I_CLS
สถิติ	NN	O	I_CLS
โลก	NN	O	I_CLS
_	PU	O	I_CLS
ครั้ง	CL	O	I_CLS
ใหม่	VV	O	I_CLS
อีก	AJ	O	I_CLS
รอบ	CL	O	E_CLS

ทั้ง	NN	O	B_CLS
ๆ	PU	O	I_CLS
_	PU	O	I_CLS
ที่	CC	O	I_CLS
เพิ่ง	AX	O	I_CLS
สร้าง	VV	O	I_CLS
สถิติ	NN	O	I_CLS
ใหม่	VV	O	I_CLS
ด้วย	PS	O	I_CLS
การ	FX	O	I_CLS
คว้า	VV	O	I_CLS
ตัว	NN	O	I_CLS
_	PU	O	I_CLS
ณัฐพงษ์	NN	B_PER	I_CLS
_	PU	I_PER	I_CLS
หวังศุภกิจโกศล	NN	E_PER	I_CLS
_	PU	O	I_CLS
มิดฟิลด์	NN	O	I_CLS
ทีม	NN	O	I_CLS
ชาติ	NN	O	I_CLS
เกาะ	NN	B_LOC	I_CLS
สุกร	NN	E_LOC	I_CLS
มา	VV	O	I_CLS
จาก	PS	O	I_CLS
_	PU	O	I_CLS
"	PU	O	I_CLS
กอง	NN	B_ORG	I_CLS
พิสูจน์	NN	I_ORG	I_CLS
หลักฐาน	NN	E_ORG	I_CLS
"	PU	O	I_CLS
_	PU	O	I_CLS
วัด	NN	B_ORG	I_CLS
เขตอุดมศักดิ์	NN	E_ORG	I_CLS
_	PU	O	I_CLS
ด้วย	PS	O	I_CLS
ค่า	NN	O	I_CLS
ตัว	NN	O	I_CLS
สูง	VV	O	I_CLS
ถึง	PS	O	I_CLS
_	PU	O	I_CLS
68	NU	B_MEA	I_CLS
_	PU	I_MEA	I_CLS
ล้าน	NU	I_MEA	I_CLS
ยูโร	CL	E_MEA	I_CLS
_	PU	O	I_CLS
(	PU	O	I_CLS
ประมาณ	AJ	O	I_CLS
_	PU	O	I_CLS
3.4	NU	B_MEA	I_CLS
_	PU	I_MEA	I_CLS
พัน	NU	I_MEA	I_CLS
ล้าน	NU	I_MEA	I_CLS
บาท	CL	E_MEA	I_CLS
)	PU	O	E_CLS



