ร้อยตรีหญิง	NN	B_DES	B_CLS
กลุ่ม	NN	B_ORG	I_CLS
พันธมิตร	NN	E_ORG	I_CLS
เยือน	VV	O	I_CLS
ลาว	NN	O	I_CLS
ถก	VV	O	I_CLS
ส่ง	VV	O	I_CLS
ม้ง	NN	O	I_CLS
กลับ	VV	O	E_CLS

พระบาทสมเด็จพระปรมินทรมหา	NN	B_DES	B_CLS
ณัฐจิรา	NN	B_PER	I_CLS
ยะแสง	NN	E_PER	I_CLS
_	PU	O	I_CLS
รัฐมนตรี	NN	O	I_CLS
ว่าการ	VV	O	I_CLS
มีเดีย	NN	B_ORG	I_CLS
แชนแนล	NN	E_ORG	I_CLS
_	PU	O	I_CLS
ให้	AV	O	I_CLS
สัมภาษณ์	VV	O	I_CLS
ก่อน	PS	O	I_CLS
เดินทาง	VV	O	I_CLS
ไป	AV	O	I_CLS
เยือน	VV	O	I_CLS
สาธารณรัฐประชาธิปไตยประชาชนลาว	NN	O	I_CLS
_	PU	O	I_CLS
(	PU	O	I_CLS
ศูนย์	NN	B_ORG	I_CLS
ฯ	NN	E_ORG	I_CLS
)	PU	O	I_CLS
_	PU	O	I_CLS
ระหว่าง	PS	B_DTM	I_CLS
วันที่	NN	I_DTM	I_CLS
_	PU	I_DTM	I_CLS
4	NU	I_DTM	I_CLS
-	PU	I_DTM	I_CLS
5	NU	I_DTM	I_CLS
_	PU	I_DTM	I_CLS
มิถุนายน	NN	E_DTM	I_CLS
_	PU	O	I_CLS
ว่า	CC	O	I_CLS
_	PU	O	I_CLS
มี	VV	O	I_CLS
กำหนดการ	NN	O	I_CLS
พบ	VV	O	I_CLS
กับ	PS	O	I_CLS
รัฐมนตรี	NN	O	I_CLS
เอฟเอโอ	NN	B_ORG	E_CLS

และ	CC	O	B_CLS
นายก	NN	O	I_CLS
รัฐมนตรี	NN	O	I_CLS
_	PU	O	I_CLS
เทศบาล	NN	B_ORG	I_CLS
นคร	NN	I_ORG	I_CLS
หาดใหญ่	NN	E_ORG	I_CLS
_	PU	O	I_CLS
จะ	AX	O	I_CLS
หยิบยก	VV	O	I_CLS
ปัญหา	NN	O	I_CLS
ม้ง	NN	O	I_CLS
ลาว	NN	O	I_CLS
หารือ	VV	O	I_CLS
ด้วย	PS	O	I_CLS
_	PU	O	I_CLS
ร้อย	NN	B_ORG	I_CLS
_	NN	I_ORG	I_CLS
ร.	NN	I_ORG	I_CLS
พัฒนา	NN	I_ORG	I_CLS
และ	NN	I_ORG	I_CLS
พิทักษ์	NN	I_ORG	I_CLS
ทรัพยากร	NN	I_ORG	I_CLS
_	NN	I_ORG	I_CLS
3012	NN	E_ORG	I_CLS
พร้อม	CC	O	I_CLS
รับ	VV	O	I_CLS
ม้ง	NN	O	I_CLS
กลับ	VV	O	E_CLS
แต่	CC	O	B_CLS
ต้อง	AX	O	I_CLS
เป็น	VV	O	I_CLS
ความ	FX	O	I_CLS
สมัครใจ	VV	O	I_CLS
ของ	PS	O	I_CLS
ม้ง	NN	O	I_CLS
ด้วย	PS	O	E_CLS

และ	CC	O	B_CLS
ปฏิเสธ	VV	O	E_CLS
ว่า	CC	O	B_CLS
ไม่	NG	O	I_CLS
ได้	AX	O	I_CLS
ทารุณ	VV	O	I_CLS
ม้ง	NN	O	E_CLS
ตามที่	CC	O	B_CLS
องค์กร	NN	O	I_CLS
แพทย์	NN	O	I_CLS
ไร้	VV	O	I_CLS
พรมแดน	NN	O	I_CLS
ระบุ	VV	O	E_CLS



