"	PU	O	B_CLS
องอาจ	NN	B_PER	I_CLS
"	PU	O	I_CLS
เซ็ง	VV	O	I_CLS
!	PU	O	I_CLS
_	PU	O	I_CLS
ศูนย์การแพทย์สิริกิติ์	NN	B_ORG	I_CLS
_	NN	I_ORG	I_CLS
โรงพยาบาล	NN	I_ORG	I_CLS
_	NN	I_ORG	I_CLS
รามาธิบดี	NN	E_ORG	I_CLS
ตี	VV	O	I_CLS
กลับ	VV	O	I_CLS
เช่า	VV	O	I_CLS
รถ	NN	O	I_CLS
เมล์	NN	O	I_CLS
ชง	VV	O	I_CLS
ศาล	NN	B_ORG	I_CLS
ฎีกา	NN	I_ORG	I_CLS
แผนก	NN	I_ORG	I_CLS
คดี	NN	I_ORG	I_CLS
อาญา	NN	I_ORG	I_CLS
ของ	NN	I_ORG	I_CLS
ผู้	NN	I_ORG	I_CLS
ดำรง	NN	I_ORG	I_CLS
ตำแหน่ง	NN	I_ORG	I_CLS
ทาง	NN	I_ORG	I_CLS
การเมือง	NN	E_ORG	I_CLS
ดู	AV	O	I_CLS
รอบคอบ	VV	O	E_CLS

ผู้สื่อข่าว	NN	O	B_CLS
รายงาน	VV	O	I_CLS
_	PU	O	I_CLS
วัน	NN	B_DTM	I_CLS
นี้	AJ	E_DTM	I_CLS
(	PU	O	I_CLS
3	NU	B_DTM	I_CLS
_	PU	I_DTM	I_CLS
มิ.ย.	NN	I_DTM	I_CLS
2552	NU	E_DTM	I_CLS
)	PU	O	E_CLS
_	PU	O	O
ว่า	CC	O	B_CLS
_	PU	O	O
ที่	NN	O	B_CLS
ประชุม	NN	O	I_CLS
ครม.	NN	O	I_CLS
มี	VV	O	I_CLS
มติ	NN	O	I_CLS
ให้	AX	O	I_CLS
ส่ง	VV	O	I_CLS
โครงการ	NN	O	I_CLS
เช้า	NN	O	I_CLS
รถ	NN	O	I_CLS
เมล์	NN	O	I_CLS
เอ็นจีวี	NN	O	I_CLS
_	PU	O	I_CLS
4,000	NU	B_NUM	I_CLS
_	PU	O	I_CLS
คัน	CL	B_MEA	E_CLS
ที่	CC	O	B_CLS
สหรัฐอาหรับเอมิเรตส์	NN	B_ORG	I_CLS
เสนอ	VV	O	I_CLS
ไป	AV	O	I_CLS
ให้	AX	O	I_CLS
คณะ	NN	O	I_CLS
กรรมการ	NN	O	I_CLS
กรมทหาร	NN	B_ORG	I_CLS
ช่าง	NN	I_ORG	I_CLS
ที่	NN	I_ORG	I_CLS
_	NN	I_ORG	I_CLS
1	NN	I_ORG	I_CLS
_	NN	I_ORG	I_CLS
กองร้อย	NN	I_ORG	I_CLS
_	NN	I_ORG	I_CLS
รักษาพระองค์	NN	E_ORG	E_CLS
ไป	AV	O	I_CLS
ศึกษา	VV	O	I_CLS
ให้	AX	O	I_CLS
รอบคอบ	VV	O	I_CLS
ก่อน	AV	O	I_CLS
_	PU	O	I_CLS
แล้ว	AX	O	I_CLS
ให้	AX	O	I_CLS
กลับ	VV	O	I_CLS
เข้า	AV	O	I_CLS
สู่	PS	O	I_CLS
ที่	NN	O	I_CLS
ประชุม	NN	O	I_CLS
ครม.	NN	O	I_CLS
ใน	PS	O	I_CLS
_	PU	O	I_CLS
1	NU	B_MEA	I_CLS
_	PU	O	I_CLS
เดือน	CL	B_MEA	E_CLS

ทั้งนี้	CC	O	B_CLS
เพื่อ	CC	O	I_CLS
ให้	AX	O	I_CLS
เกิด	VV	O	I_CLS
ความ	FX	O	I_CLS
โปร่งใส	VV	O	I_CLS
หลัง	PS	O	I_CLS
จาก	PS	O	I_CLS
เป็น	VV	O	E_CLS
ที่	CC	O	B_CLS
เคลือบแคลง	VV	O	I_CLS
สงสัย	VV	O	E_CLS
ว่า	CC	O	B_CLS
อาจ	AX	O	I_CLS
มีการ	FX	O	I_CLS
ทุจริต	VV	O	I_CLS
_	PU	O	I_CLS
ซึ่ง	CC	O	I_CLS
มติ	NN	O	I_CLS
ครม.	NN	O	I_CLS
ดังกล่าว	AJ	O	I_CLS
ทำให้	CC	O	I_CLS
นาย	NN	B_TTL	I_CLS
จรัส	NN	B_PER	I_CLS
_	PU	I_PER	I_CLS
ปริศนานันทกุล	NN	E_PER	I_CLS
_	PU	O	I_CLS
พลตรี	NN	B_DES	I_CLS
ตุรกี	NN	B_ORG	I_CLS
เสีย	VV	O	I_CLS
ความ	FX	O	I_CLS
รู้สึก	VV	O	I_CLS
พอสมควร	VV	O	E_CLS
_	PU	O	O
เพราะ	CC	O	B_CLS
กรม	NN	B_ORG	I_CLS
ป้องกัน	NN	I_ORG	I_CLS
และ	NN	I_ORG	I_CLS
บรรเทา	NN	I_ORG	I_CLS
สาธารณภัย	NN	E_ORG	I_CLS
ได้	AX	O	I_CLS
พิจารณา	VV	O	I_CLS
มา	AV	O	I_CLS
อย่าง	FX	O	I_CLS
ดี	VV	O	I_CLS
แล้ว	AX	O	E_CLS



