จีเอ็ม	NN	B_ORG	B_CLS
และ	CC	O	I_CLS
ตลาด	NN	B_ORG	I_CLS
ค้า	NN	I_ORG	I_CLS
ยาเสพติด	NN	I_ORG	I_CLS
โลก	NN	E_ORG	I_CLS
แสดง	VV	O	I_CLS
ความ	FX	O	I_CLS
กังวล	VV	O	I_CLS
ต่อ	PS	O	I_CLS
นโยบาย	NN	O	I_CLS
ของ	PS	O	I_CLS
กรม	NN	B_ORG	I_CLS
ป่าไม้	NN	E_ORG	E_CLS

บริษัท	NN	B_ORG	B_CLS
ไทยแอร์โร่	NN	I_ORG	I_CLS
_	NN	I_ORG	I_CLS
จำกัด	NN	I_ORG	I_CLS
_	NN	I_ORG	I_CLS
สาขา	NN	I_ORG	I_CLS
พิษณุโลก	NN	E_ORG	I_CLS
ของ	PS	O	I_CLS
กกต.	NN	B_ORG	I_CLS
กลาง	NN	E_ORG	I_CLS
รายงาน	VV	O	I_CLS
ว่า	CC	O	I_CLS
_	PU	O	I_CLS
นาย	NN	B_TTL	I_CLS
ไชยวัฒนา	NN	B_PER	I_CLS
_	PU	I_PER	I_CLS
ซารัมย์	NN	E_PER	I_CLS
_	PU	O	I_CLS
ผู้นำ	NN	O	I_CLS
ชมรม	NN	B_ORG	I_CLS
คน	NN	I_ORG	I_CLS
คิดถึง	NN	I_ORG	I_CLS
ทักษิณ	NN	E_ORG	I_CLS
และ	CC	O	I_CLS
โค้ช	NN	B_DES	I_CLS
ธิวัลรัตน์	NN	B_PER	I_CLS
_	PU	I_PER	I_CLS
ดนตรีเสนาะ	NN	E_PER	I_CLS
_	PU	O	I_CLS
ของ	PS	O	I_CLS
แผนก	NN	B_ORG	I_CLS
ช่างกล	NN	I_ORG	I_CLS
โรงงาน	NN	I_ORG	I_CLS
_	NN	I_ORG	I_CLS
โรงเรียน	NN	I_ORG	I_CLS
ชำนิ	NN	I_ORG	I_CLS
เทคโนโลยี	NN	E_ORG	I_CLS
แสดง	VV	O	I_CLS
ความ	FX	O	I_CLS
กังวล	VV	O	I_CLS
ร่วม	VV	O	I_CLS
กัน	PR	O	I_CLS
เกี่ยวกับ	VV	O	I_CLS
นโยบาย	NN	O	I_CLS
ของ	PS	O	I_CLS
รัฐบาล	NN	O	I_CLS
ใหม่	VV	O	I_CLS
ของ	PS	O	I_CLS
รอง	NN	B_DES	I_CLS
คณบดี	NN	E_DES	I_CLS
รัฐมนตรี	NN	I_DES	I_CLS
พิบูลย์	NN	B_PER	I_CLS
_	PU	I_PER	I_CLS
ทองใจสด	NN	E_PER	I_CLS
_	PU	O	I_CLS
แห่ง	PS	O	I_CLS
บิ๊กซี	NN	B_ORG	E_CLS
ที่	CC	O	B_CLS
ยอม	VV	O	E_CLS
ให้	CC	O	B_CLS
มีการ	FX	O	I_CLS
จัดตั้ง	VV	O	I_CLS
สาธารณรัฐ	NN	B_ORG	I_CLS
ขึ้น	VV	O	E_CLS

โดย	CC	O	B_CLS
ต้อง	AX	O	I_CLS
เป็น	VV	O	I_CLS
ไป	AV	O	I_CLS
ตาม	VV	O	I_CLS
เงื่อนไข	NN	O	I_CLS
บาง	AJ	O	I_CLS
ประการ	CL	O	E_CLS
_	PU	O	O
ซึ่ง	CC	O	B_CLS
เป็น	VV	O	I_CLS
ความ	FX	O	I_CLS
พยายาม	VV	O	I_CLS
ยุติ	VV	O	I_CLS
ปัญหา	NN	O	I_CLS
_	PU	O	I_CLS
ระหว่าง	PS	O	I_CLS
คณะ	NN	B_ORG	I_CLS
กรรมการ	NN	I_ORG	I_CLS
สมานฉันท์	NN	E_ORG	I_CLS
กับ	PS	O	I_CLS
มูลนิธิ	NN	B_ORG	E_CLS
ผู้	NN	I_ORG	I_CLS
บริโภค	NN	E_ORG	I_CLS

ขณะ	CC	O	B_CLS
ที่	CC	O	I_CLS
ผู้นำ	NN	O	I_CLS
ซีเอ็มที	NN	B_ORG	I_CLS
มี	VV	O	I_CLS
กำหนด	VV	O	I_CLS
การ	FX	O	I_CLS
เยือน	VV	O	I_CLS
วัด	NN	B_LOC	I_CLS
ศาลา	NN	I_LOC	I_CLS
แดง	NN	E_LOC	I_CLS
ของ	PS	O	I_CLS
_	PU	O	I_CLS
อุทยานแห่งชาติ	NN	B_LOC	I_CLS
เขา	NN	I_LOC	I_CLS
พระ	NN	I_LOC	I_CLS
วิหาร	NN	E_LOC	I_CLS
เป็น	VV	O	I_CLS
ประเทศ	NN	O	I_CLS
ต่อไป	AJ	O	I_CLS
ใน	PS	O	I_CLS
การ	FX	O	I_CLS
เยือน	VV	O	I_CLS
ภูมิภาค	NN	O	I_CLS
นี้	AJ	O	I_CLS
.	PU	O	E_CLS



