สัญญา	NN	B_PER	B_CLS
ยัน	VV	O	I_CLS
เคลียร์	VV	O	I_CLS
ผบ.	NN	O	I_CLS
การ	NN	B_ORG	I_CLS
ท่องเที่ยว	NN	I_ORG	I_CLS
แห่ง	NN	I_ORG	I_CLS
ประเทศ	NN	I_ORG	I_CLS
ไทย	NN	E_ORG	I_CLS
_	PU	O	I_CLS
แล้ว	AX	O	E_CLS

วัน	NN	O	B_CLS
นี้	AJ	O	I_CLS
_	PU	O	I_CLS
(	PU	O	I_CLS
2	NU	B_DTM	I_CLS
_	PU	I_DTM	I_CLS
ส.ค.	NN	E_DTM	I_CLS
)	PU	O	I_CLS
_	PU	O	I_CLS
นาย	NN	B_TTL	I_CLS
ศุภณัฐ	NN	B_PER	I_CLS
_	PU	I_PER	I_CLS
ธนิกกุล	NN	E_PER	I_CLS
_	PU	O	I_CLS
ร้อยเวร	NN	B_DES	I_CLS
ฯ	NN	E_DES	I_CLS
รัฐมนตรี	NN	E_DES	I_CLS
_	PU	O	I_CLS
กล่าว	VV	O	I_CLS
ถึง	PS	O	I_CLS
ความ	FX	O	I_CLS
คืบหน้า	VV	O	I_CLS
คดี	NN	O	I_CLS
ลอบ	VV	O	I_CLS
ยิง	VV	O	I_CLS
_	PU	O	I_CLS
นาย	NN	B_TTL	I_CLS
ประภัตร	NN	B_PER	I_CLS
_	PU	I_PER	I_CLS
สรรณ์ไตรภพ	NN	E_PER	I_CLS
_	PU	O	I_CLS
แกนนำ	NN	O	I_CLS
กลุ่ม	NN	B_ORG	I_CLS
ธุรกิจ	NN	I_ORG	I_CLS
น้ำมัน	NN	I_ORG	I_CLS
บริษัท_ปตท._จำกัด(มหาชน	NN	E_ORG	E_CLS
_	PU	O	O
โดย	CC	O	B_CLS
ยืนยัน	VV	O	E_CLS
ว่า	CC	O	B_CLS
ได้	AX	O	I_CLS
เคลียร์	VV	O	I_CLS
กับ	PS	O	I_CLS
_	PU	O	I_CLS
ผบ.	NN	O	I_CLS
ทีมสิงโตคำราม	NN	B_ORG	I_CLS
แล้ว	AX	O	E_CLS

โดย	CC	O	B_CLS
ผบ.	NN	O	I_CLS
ศาลเยาวชนและ	NN	B_ORG	I_CLS
ครอบครัวกลาง	NN	E_ORG	I_CLS
ขอ	VV	O	I_CLS
ลา	VV	O	I_CLS
งาน	NN	O	E_CLS
_	PU	O	O
และ	CC	O	B_CLS
ระงับ	VV	O	I_CLS
โผ	NN	O	I_CLS
แต่งตั้ง	VV	O	I_CLS
โยกย้าย	VV	O	I_CLS
นาย	NN	O	I_CLS
ตำรวจ	NN	O	I_CLS
ประจำ	VV	O	I_CLS
ปี	NN	O	I_CLS
นี้	AJ	O	E_CLS
_	PU	O	O
และ	CC	O	B_CLS
คาด	VV	O	E_CLS
ว่า	CC	O	B_CLS
คดี	NN	O	I_CLS
จะ	AX	O	I_CLS
แล้วเสร็จ	VV	O	E_CLS
ก่อน	CC	O	B_CLS
เกษียณ	VV	O	I_CLS
อายุ	NN	O	I_CLS
ราชการ	NN	O	I_CLS
แน่นอน	VV	O	E_CLS

ขณะ	NN	O	B_CLS
เดียว	NU	O	I_CLS
กัน	PR	O	I_CLS
_	PU	O	I_CLS
ขอรอ	VV	O	I_CLS
ความ	FX	O	I_CLS
ชัดเจน	VV	O	I_CLS
จาก	PS	O	I_CLS
บมจ.เอสวีโอเอ	NN	B_ORG	E_CLS
_	PU	O	I_CLS
หรือ	CC	O	I_CLS
_	PU	O	I_CLS
องค์การ	NN	B_ORG	I_CLS
บริหาร	NN	I_ORG	I_CLS
ส่วน	NN	I_ORG	I_CLS
ตำบล	NN	I_ORG	I_CLS
คลองสะแก	NN	E_ORG	I_CLS
_	PU	O	I_CLS
ใน	PS	O	I_CLS
มูล	NN	O	I_CLS
คดี	NN	O	I_CLS
_	PU	O	I_CLS
7	NU	B_NUM	I_CLS
_	PU	O	I_CLS
ต.ค.	NN	B_DTM	I_CLS
ก่อน	AV	O	I_CLS
_	PU	O	I_CLS
และ	CC	O	I_CLS
เชื่อ	VV	O	E_CLS
ว่า	CC	O	B_CLS
ปัญหา	NN	O	I_CLS
ทุก	AJ	O	I_CLS
อย่าง	CL	O	I_CLS
จะ	AX	O	I_CLS
จบ	VV	O	I_CLS
.	PU	O	E_CLS



