คุม	VV	O	B_CLS
ตัว	NN	O	I_CLS
_	PU	O	I_CLS
'	PU	O	I_CLS
สฤษดิ์	NN	B_PER	I_CLS
'	PU	O	I_CLS
_	PU	O	I_CLS
ฝาก	VV	O	I_CLS
ขัง	VV	O	I_CLS
คดี	NN	O	I_CLS
หมิ่น	VV	O	I_CLS
เบื้อง	NN	O	I_CLS
สูง	VV	O	E_CLS

ผู้สื่อข่าว	NN	O	B_CLS
รายงาน	VV	O	I_CLS
ว่า	CC	O	E_CLS

หลัง	CC	O	B_CLS
ครบ	VV	O	I_CLS
กำหนด	VV	O	I_CLS
อำนาจ	NN	O	I_CLS
การ	FX	O	I_CLS
ควบคุม	VV	O	I_CLS
ตัว	NN	O	I_CLS
_	PU	O	I_CLS
นาย	NN	B_TTL	I_CLS
ศิริวรรณ	NN	B_PER	I_CLS
_	PU	I_PER	I_CLS
มะยูโซ๊ะ	NN	E_PER	I_CLS
_	PU	O	I_CLS
หรือ	CC	O	I_CLS
_	PU	O	I_CLS
ธานินท์	NN	B_PER	I_CLS
_	PU	O	I_CLS
อายุ	NN	O	I_CLS
_	PU	O	I_CLS
76	NU	B_MEA	I_CLS
_	PU	O	I_CLS
ปี	CL	B_MEA	I_CLS
_	PU	O	I_CLS
ของ	PS	O	I_CLS
ตำรวจ	NN	O	I_CLS
_	PU	O	I_CLS
ซึ่ง	CC	O	I_CLS
ถูก	AX	O	I_CLS
จับ	VV	O	I_CLS
ดำเนินคดี	VV	O	I_CLS
ข้อหา	NN	O	I_CLS
หมิ่น	VV	O	I_CLS
เบื้อง	NN	O	I_CLS
สูง	VV	O	E_CLS

ขณะ	PS	O	B_CLS
บรรยาย	VV	O	I_CLS
พิเศษ	VV	O	I_CLS
ที่	PS	O	I_CLS
วัด	NN	B_LOC	I_CLS
บำเพ็ญ	NN	I_LOC	I_CLS
จีน	NN	I_LOC	I_CLS
พรต	NN	E_LOC	I_CLS
พระโพธิสัตว์กวนอิม	NN	B_LOC	I_CLS
_	PU	O	I_CLS
เมื่อ	PS	O	I_CLS
วันที่	NN	B_DTM	I_CLS
_	PU	I_DTM	I_CLS
6	NU	I_DTM	I_CLS
_	PU	I_DTM	I_CLS
พฤศจิกายน	NN	I_DTM	I_CLS
_	PU	I_DTM	I_CLS
2551	NU	E_DTM	I_CLS
_	PU	O	I_CLS
วัน	NN	O	I_CLS
นี้	AJ	O	I_CLS
(	PU	O	I_CLS
4	NU	B_DTM	I_CLS
_	PU	I_DTM	I_CLS
พ.ค.	NN	E_DTM	I_CLS
)	PU	O	I_CLS
_	PU	O	I_CLS
พนักงาน	NN	O	I_CLS
สอบสวน	VV	O	I_CLS
มหาวิทยาลัย	NN	B_ORG	I_CLS
ราชภัฏ	NN	I_ORG	I_CLS
สวน	NN	I_ORG	I_CLS
ดุสิต	NN	E_ORG	I_CLS
หอ	NN	B_LOC	I_CLS
แก้ว	NN	I_LOC	I_CLS
มุกดาหาร	NN	E_LOC	I_CLS
_	PU	O	I_CLS
ได้	AX	O	I_CLS
นำ	VV	O	I_CLS
ตัว	NN	O	I_CLS
_	PU	O	I_CLS
นาย	NN	B_TTL	I_CLS
พันธ์ศักดิ์	NN	B_PER	I_CLS
_	PU	O	I_CLS
ไป	AV	O	I_CLS
ฝาก	VV	O	I_CLS
ขัง	VV	O	I_CLS
ที่	PS	O	I_CLS
วัด	NN	B_LOC	I_CLS
สุ	NN	I_LOC	I_CLS
ปัฏนา	NN	I_LOC	I_CLS
ราม	NN	I_LOC	I_CLS
วรวิหาร	NN	E_LOC	I_CLS
ปราสาท	NN	B_LOC	E_CLS
เขา	NN	I_LOC	I_CLS
น้อย	NN	I_LOC	I_CLS
สีชมพู	NN	E_LOC	I_CLS

โดย	CC	O	B_CLS
มี	VV	O	I_CLS
_	PU	O	I_CLS
นาย	NN	B_TTL	I_CLS
ถิรเดช	NN	B_PER	I_CLS
_	PU	I_PER	I_CLS
ศรนุวัตร์	NN	E_PER	I_CLS
_	PU	O	I_CLS
ผบช.น.	NN	B_DES	I_CLS
วอลล์สตรีท	NN	B_ORG	I_CLS
_	PU	O	I_CLS
ศูนย์	NN	B_ORG	I_CLS
บริการ	NN	I_ORG	I_CLS
ข้อมูล	NN	I_ORG	I_CLS
ภาค	NN	I_ORG	I_CLS
รัฐ	NN	I_ORG	I_CLS
เพื่อประชาชน	NN	I_ORG	I_CLS
_	NN	I_ORG	I_CLS
GCC	NN	I_ORG	I_CLS
_	NN	I_ORG	I_CLS
1111	NN	E_ORG	I_CLS
วัด	NN	B_LOC	I_CLS
พระศรีรัตนศาสดาราม	NN	E_LOC	I_CLS
_	PU	O	I_CLS
ได้	AX	O	I_CLS
ใช้	VV	O	I_CLS
ตำแหน่ง	NN	O	I_CLS
ขอ	VV	O	I_CLS
ประกัน	VV	O	I_CLS
ตัว	NN	O	I_CLS
ออก	AV	O	I_CLS
ไป	VV	O	E_CLS

ด้าน	PS	O	B_CLS
_	PU	O	I_CLS
นาย	NN	B_TTL	I_CLS
ชวน	NN	B_PER	I_CLS
_	PU	O	I_CLS
กล่าว	VV	O	I_CLS
ยืนยัน	VV	O	I_CLS
ใน	PS	O	I_CLS
ความ	FX	O	I_CLS
จงรักภักดี	VV	O	I_CLS
_	PU	O	I_CLS
แต่	CC	O	I_CLS
เรื่อง	NN	O	I_CLS
ที่	CC	O	I_CLS
เกิด	VV	O	I_CLS
ขึ้น	AV	O	E_CLS
_	PU	O	O
เนื่องจาก	CC	O	B_CLS
เป็น	VV	O	I_CLS
เรื่อง	NN	O	I_CLS
ทาง	NN	O	I_CLS
การเมือง	NN	O	E_CLS
ที่	CC	O	B_CLS
หวัง	VV	O	I_CLS
ทำลาย	VV	O	I_CLS
ความ	FX	O	I_CLS
น่า	FX	O	I_CLS
เชื่อถือ	VV	O	I_CLS
ไป	AV	O	I_CLS
ยัง	PS	O	I_CLS
King	NN	B_ORG	I_CLS
_	NN	I_ORG	I_CLS
Size	NN	E_ORG	I_CLS
.	PU	O	E_CLS



