ปกครอง	VV	O	B_CLS
ตนเอง	PR	O	E_CLS

ผู้	NN	B_DES	B_CLS
อำนวยการ	NN	I_DES	I_CLS
การ	NN	I_DES	I_CLS
เลือกตั้ง	NN	E_DES	I_CLS
อาทิตย์	NN	B_PER	I_CLS
ที่	PS	I_PER	I_CLS
_	PU	I_PER	I_CLS
2	NU	I_PER	I_CLS
_	PU	I_PER	I_CLS
แห่ง	PS	I_PER	I_CLS
วิบูลย์ธนากุล	NN	E_PER	I_CLS
_	PU	O	I_CLS
ทรง	VV	O	I_CLS
มอบ	VV	O	I_CLS
เอกสาร	NN	O	I_CLS
สิทธิ	NN	O	I_CLS
ปกครอง	VV	O	I_CLS
ตนเอง	PR	O	I_CLS
สกว.	NN	B_ORG	I_CLS
ให้	VV	O	I_CLS
แก่	PS	O	I_CLS
นาย	NN	B_TTL	I_CLS
กิตติศักดิ์	NN	B_PER	I_CLS
_	PU	I_PER	I_CLS
จริตงาม	NN	E_PER	I_CLS
_	PU	O	I_CLS
ประธาน	NN	O	I_CLS
ปกครอง	VV	O	I_CLS
ตนเอง	PR	O	I_CLS
คมชัดลึก	NN	B_ORG	I_CLS
_	PU	O	I_CLS
ใน	PS	O	I_CLS
พิธี	NN	O	I_CLS
ฉลอง	VV	O	I_CLS
วัน	NN	O	I_CLS
ชาติ	NN	O	I_CLS
เนชั่น	NN	B_ORG	I_CLS
ฯ	NN	E_ORG	I_CLS
_	PU	O	I_CLS
ที่	PS	O	I_CLS
ตลาด	NN	B_LOC	I_CLS
หนอง	NN	I_LOC	I_CLS
มน	NN	E_LOC	I_CLS
_	PU	O	I_CLS
วัด	NN	B_LOC	I_CLS
ร่อง	NN	I_LOC	I_CLS
ขุ่น	NN	E_LOC	I_CLS
_	PU	O	I_CLS
เมือง	NN	O	I_CLS
เอก	NN	O	I_CLS
ของ	PS	O	I_CLS
สวนสาธารณะ	NN	B_LOC	I_CLS
พญา	NN	I_LOC	I_CLS
แถน	NN	E_LOC	I_CLS
_	PU	O	I_CLS
เมื่อ	PS	O	I_CLS
วันที่	NN	B_DTM	I_CLS
_	PU	I_DTM	I_CLS
21	NU	I_DTM	I_CLS
_	PU	I_DTM	I_CLS
มิถุนายน	NN	E_DTM	I_CLS
_	PU	O	I_CLS
ซึ่ง	CC	O	I_CLS
มี	VV	O	I_CLS
ขึ้น	AV	O	I_CLS
หลัง	CC	O	I_CLS
จาก	PS	O	I_CLS
เมื่อ	PS	O	I_CLS
_	PU	O	I_CLS
6	NU	B_MEA	I_CLS
_	PU	I_MEA	I_CLS
เดือน	CL	E_MEA	I_CLS
ก่อน	NU	O	I_CLS
_	PU	O	I_CLS
ชาว	FX	O	I_CLS
ถนน	NN	B_LOC	I_CLS
ราชินี	NN	E_LOC	I_CLS
ร้อย	NU	B_MEA	I_CLS
ละ	AJ	I_MEA	I_CLS
_	PU	I_MEA	I_CLS
75	NU	E_MEA	I_CLS
_	PU	O	I_CLS
ได้	AX	O	I_CLS
ลง	VV	O	I_CLS
ประชามติ	NN	O	I_CLS
ปกครอง	VV	O	I_CLS
ตนเอง	PR	O	E_CLS
หลัง	CC	O	B_CLS
จาก	PS	O	I_CLS
ตก	VV	O	I_CLS
อยู่	VV	O	I_CLS
ภาย	NN	O	I_CLS
ใต้	PS	O	I_CLS
การ	FX	O	I_CLS
ปกครอง	VV	O	I_CLS
โดย	FX	O	I_CLS
ตรง	VV	O	I_CLS
ของ	PS	O	I_CLS
องค์กร	NN	B_ORG	I_CLS
สตรี	NN	E_ORG	I_CLS
มา	AV	O	I_CLS
นาน	VV	O	I_CLS
ถึง	PS	O	I_CLS
_	PU	O	I_CLS
500	NU	B_MEA	I_CLS
_	PU	I_MEA	I_CLS
ปี	CL	E_MEA	E_CLS

สิทธิ	NN	O	B_CLS
ปกครอง	VV	O	I_CLS
ตนเอง	PR	O	E_CLS
ทำให้	CC	O	B_CLS
ปากีสถาน	NN	B_ORG	I_CLS
มี	VV	O	I_CLS
สิทธิ	NN	O	I_CLS
ครอบครอง	VV	O	I_CLS
แหล่ง	NN	O	I_CLS
ทรัพยากร	NN	O	I_CLS
ธรรมชาติ	NN	O	I_CLS
ทั้ง	CC	O	I_CLS
ก๊าซ	NN	O	I_CLS
_	PU	O	I_CLS
ทองคำ	NN	O	I_CLS
_	PU	O	I_CLS
อัญมณี	NN	O	I_CLS
และ	CC	O	I_CLS
น้ำมัน	NN	O	E_CLS



